1111111111111111111111111111111111111111111111111111111
1000000000001110000000000000000000000001110000001111111
10000C0000000000000000000000000000000000000000000011111
1000000000000000111000000000000000000000000000000000111
10000000000000001000000000000X0000000011100000000000001
1000000000P00000100000000000000000000011100000000000001
1000000000000000000000000000000000001111100000000000001
1000000000000000000000111000000000000000000000000000001
11111110000000000000000000000000000000000000000000000E1
1111111111111111111111111111111111111111111111111111111
