1111111111111111111111111111111111111111111111111111111
1000000000000000000000000000000000000000011111111000001
10000C0000000000000000000000000000000000001111111000001
1000000000000000000000000000000000000000000000000000001
1000000000000000000000000000000000000000000000000000001
1000000011P000000000000000000000000000C0000000000000001
1000000011100000000000000000000000000000000000001111111
100000000000000000000000000000X0000000000000000000000C1
1000000000000000000000000000110000000000000000000000001
1000000000000000110000001111110000000000000000000000001
1000000000000011110000000000110000000000000000000000001
100000000001111111C0000000011100000000000000000000000E1
1111111111111111111111111111111111111111111111111111111
