1111111111111111111111111111111111111111111111111111111
1000000000000000000000000000000000000011111111111111111
10000C000000000000000000000000000000000000000000000X001
1000000000000000000000000000000000000000000000000000001
1000000000000000000111111111111111000000000000000000001
10000000000000000000000000000000000000C000000000000X001
100000000000000P001110000000000000000000000000000000001
100000000000000001111000000000X000000000000000000000001
1000000000000000000000000000000000011111000000000000001
10000X0000000000000000000000001111111111000000X00000001
1000000000000000000000000000000000000000000000000000001
10000C000000011111111111111111000000000C0000000000000E1
1111111111111111111111111111111111111111111111111111111
